000000000011111111112222222**
012345678901234567890123456**
02                         02
03 HHHHHHHHHHHHHHHHHHHHHHH 03
04 H          .          H 04
05 H          .          H 05
06 H          .          H 06
07 H          .          H 07
08 H          .          H 08
19 H          .          H 19
10 H          .          H 10
11 H          .          H 11
12 H          .          H 12
13 H       #  .  ,~      H 13
14 H.....................H 14
15 H          .          H 15
16 H          .          H 16
17 H          .          H 17
18 H          .          H 18
19 H          .          H 29
20 H          .          H 20
21 H          .          H 21
22 H          .          H 22
23 H          .          H 23
24 H          .          H 24
25 HHHHHHHHHHHHHHHHHHHHHHH 25
26                         26
**00000000111111111122222222*
**2345678901234567890123456*8